50
0 0 1584 48 3168 32 0
1 0 3072 144 64 160 0
2 0 3056 240 544 32 0
3 0 3056 368 32 32 0
4 0 3088 368 32 32 0
5 0 1952 176 186 32 0
6 0 1664 240 314 32 0
7 0 1424 176 96 32 0
8 6 72 160 16 32 8
9 6 1096 160 16 32 13
10 6 1544 160 16 32 1
11 6 1736 160 16 32 1
12 6 2184 160 16 32 1
13 6 2312 160 16 32 1
14 6 2440 160 16 32 1
15 6 2056 160 16 32 1
16 6 2632 256 16 32 1
17 6 2792 160 16 32 1
18 6 2952 160 16 32 1
19 6 2952 336 16 32 9
20 22 3056 304 32 32 1
21 27 3072 80 32 32 0
22 26 16 48 32 32 0
23 7 1650 272 48 30 1
24 7 1400 208 48 30 1
25 7 1880 208 48 30 1
26 4 1520 272 32 32 0
27 4 1392 208 32 32 0
28 4 2800 272 32 32 0
29 2 2608 80 32 32 0
30 2 1456 208 32 32 0
31 2 1264 80 32 32 0
32 3 1808 272 32 32 0
33 1 1872 208 32 32 0
34 6 1544 352 16 32 8
35 6 1736 352 16 32 5
36 6 1288 288 16 32 8
37 10 1040 96 32 64 1
38 10 816 96 32 64 1
39 10 560 96 32 64 1
40 10 304 96 32 64 1
41 10 2288 96 32 64 1
42 10 2160 96 32 64 1
43 10 2416 96 32 64 1
44 10 2896 96 32 64 1
45 25 -3078 -304 44 96 0
46 2 -336 -80 32 32 0
47 6 320 160 16 32 1
48 6 576 160 16 32 1
49 6 832 160 16 32 1
0 0 0 5632 37 38 39 40 41 42 43 44
1 0 0 2816 37 38 39 40 41 42 43 44
11 0 0 1408 37 38 39 40 41 42 43 44
111 0 0 704 48 47 46 40 39 22 8 0 37 38 39 40 41 42 43 44
112 704 0 1408 49 38 37 36 31 27 24 9 7 0 39 40 41 42 43 44
113 0 704 704 37 38 39 40 41 42 43 44
114 704 704 1408 37 38 39 40 41 42 43 44
12 1408 0 2816 37 38 39 40 41 42 43 44
121 1408 0 2112 35 34 33 32 30 26 25 24 23 15 11 10 7 6 5 0 37 38 39 40 41 42 43 44
122 2112 0 2816 43 42 41 29 28 17 16 14 13 12 2 0 37 38 39 40 41 42 43 44
123 1408 704 2112 37 38 39 40 41 42 43 44
124 2112 704 2816 37 38 39 40 41 42 43 44
13 0 1408 1408 37 38 39 40 41 42 43 44
14 1408 1408 2816 37 38 39 40 41 42 43 44
2 2816 0 5632 37 38 39 40 41 42 43 44
21 2816 0 4224 37 38 39 40 41 42 43 44
211 2816 0 3520 45 44 21 20 19 18 4 3 2 1 0 37 38 39 40 41 42 43 44
212 3520 0 4224 37 38 39 40 41 42 43 44
213 2816 704 3520 37 38 39 40 41 42 43 44
214 3520 704 4224 37 38 39 40 41 42 43 44
22 4224 0 5632 37 38 39 40 41 42 43 44
23 2816 1408 4224 37 38 39 40 41 42 43 44
24 4224 1408 5632 37 38 39 40 41 42 43 44
3 0 2816 2816 37 38 39 40 41 42 43 44
4 2816 2816 5632 37 38 39 40 41 42 43 44
